1111111111111
1000000000001
10C000000C001
1000011111001
10P0000001011
1000000001E11
1111111111111
