111111111111111
1P000000C000001
100011111100001
1C0000100010001
100000011000C01
100C000000000E1
1C0011000111001
100000C00000001
111111111111111
